WWWWWWWWWWWWWWWWWWWWWWWWWWWWWWWWWWWWWWWWWWWWWWWWWWWWWW
W00L00000W0000000000000W000W0000000000000000000000000W
W00E00000W000000L0000W000W000W00000000000000000000000W
W00000000WWWWWWWWWWWWWWWWWWWWWWWWDWWWWWWWWWWWWWWWWWWWW
W00000000W000000000000000000000W000W00000000000000000W
WWWWWWWDWW000000000000000000000WWDWW00000000000000000W
W0000000000000000000000000000000000000000000000000000W
W0000P00000000000000000000000000000000000000000000000W
W0000000000000000000000000000000000000000000000000000W
W0000000000000000000000000000000000000000000000000000W
W0000000000000000000000000000000000000000000000000000W
W0000000000000000000000000000000000000000000000000000W
W0000000000000000000000000000000000000000000000000000W
W0000000000000000000000000000000000000000000000000000W
W0000000000000000000000000000000000000000000000000000W
W0000000000000000000000000000000000000000000000000000W
W0000000000000000000000000000000000000000000000000000W
W0000000000000000000000000000000000000000000000000000W
W0000000000000000000000000000000000000000000000000000W
W0000000000000000000000000000000000000000000000000000W
W0000000000000000000000000000000000000000000000000000W
W0000000000000000000000000000000000000000000000000000W
W0000000000000000000000000000000000000000000000000000W
WWWWWWWWWWWWWWWWWWWWWWWWWWWWWWWWWWWWWWWWWWWWWWWWWWWWWW